%%%%%%%
%   P %
% %%% %
%  %  %
%%   %%
% .%%%%
%%%%%%%
